2222222222
2000000002
2000000002
2000000442
2000040002
2003000002
2222222222