2a2a2a2a2a2a2a2a2a2
2a0a0a0a0a0a0a0a0a2
2a0a0a0a0a0a0a0a0a2
2a0a0a0a0a0a0a4a4a2
2a0a0a0a0a4a0a0a0a2
2a0a0a3a0a0a0a0a0a2
2a2a2a2a2a2a2a2a2a2